//MAP CONVERTED BY dmm2tgm.py THIS HEADER COMMENT PREVENTS RECONVERSION, DO NOT REMOVE
"ac" = (
/obj/effect/turf_decal/siding/thinplating/dark/corner,
/turf/open/floor/wood/parquet,
/area/space)
"ah" = (
/obj/structure/table/reinforced/plastitaniumglass,
/turf/open/floor/mineral/plastitanium,
/area/space)
"cH" = (
/obj/effect/decal/hammerandsickle,
/turf/open/floor/mineral/plastitanium/red,
/area/space)
"cQ" = (
/obj/structure/railing,
/turf/open/floor/iron/stairs/right{
	dir = 8
	},
/area/space)
"dh" = (
/obj/machinery/vending/cigarette/russian,
/turf/open/floor/mineral/plastitanium/red,
/area/space)
"eK" = (
/obj/structure/table/wood,
/turf/open/floor/mineral/plastitanium/red,
/area/space)
"gt" = (
/obj/effect/turf_decal/siding/thinplating/dark/corner,
/obj/effect/turf_decal/siding/thinplating/dark{
	dir = 9
	},
/turf/open/floor/wood/parquet,
/area/space)
"gU" = (
/obj/structure/railing/corner,
/turf/open/floor/vault{
	desc = "Space tarmac, for space roads.";
	name = "garage floor"
	},
/area/space)
"he" = (
/obj/structure/table/wood/poker,
/turf/open/floor/mineral/plastitanium/red,
/area/space)
"hN" = (
/turf/closed/wall/mineral/plastitanium/nodiagonal,
/area/space)
"hQ" = (
/obj/structure/chair/sofa/right{
	dir = 8
	},
/turf/open/floor/mineral/plastitanium/red,
/area/space)
"ko" = (
/obj/effect/turf_decal/siding/thinplating/dark{
	dir = 4
	},
/turf/open/floor/wood/parquet,
/area/space)
"kT" = (
/obj/effect/turf_decal/siding/thinplating/dark{
	dir = 8
	},
/turf/open/floor/wood/parquet,
/area/space)
"lq" = (
/obj/structure/table/wood,
/turf/open/floor/wood/parquet,
/area/space)
"nL" = (
/obj/structure/chair/sofa/corner,
/turf/open/floor/mineral/plastitanium/red,
/area/space)
"oH" = (
/obj/effect/turf_decal/siding/thinplating/dark/corner{
	dir = 8
	},
/obj/effect/turf_decal/siding/thinplating/dark{
	dir = 5
	},
/turf/open/floor/wood/parquet,
/area/space)
"pQ" = (
/obj/structure/chair/sofa/right{
	dir = 4
	},
/turf/open/floor/mineral/plastitanium/red,
/area/space)
"pZ" = (
/obj/effect/turf_decal/siding/thinplating/dark{
	dir = 5
	},
/turf/open/floor/wood/parquet,
/area/space)
"qL" = (
/obj/structure/railing{
	dir = 4
	},
/turf/open/floor/vault{
	desc = "Space tarmac, for space roads.";
	name = "garage floor"
	},
/area/space)
"ra" = (
/obj/effect/turf_decal/siding/thinplating/dark{
	dir = 8
	},
/obj/effect/turf_decal/siding/thinplating/dark{
	dir = 4
	},
/turf/open/floor/wood/parquet,
/area/space)
"rB" = (
/obj/effect/turf_decal/siding/thinplating/dark/corner{
	dir = 4
	},
/turf/open/floor/wood/parquet,
/area/space)
"sn" = (
/obj/structure/chair/sofa,
/turf/open/floor/mineral/plastitanium/red,
/area/space)
"sE" = (
/turf/open/floor/vault{
	desc = "Space tarmac, for space roads.";
	name = "garage floor"
	},
/area/space)
"uf" = (
/obj/structure/chair/sofa/left{
	dir = 8
	},
/turf/open/floor/mineral/plastitanium/red,
/area/space)
"uK" = (
/obj/structure/chair/sofa/left{
	dir = 4
	},
/turf/open/floor/mineral/plastitanium/red,
/area/space)
"wb" = (
/turf/open/space/basic,
/area/space)
"wE" = (
/obj/effect/turf_decal/siding/thinplating/dark/corner{
	dir = 8
	},
/turf/open/floor/wood/parquet,
/area/space)
"yg" = (
/obj/structure/chair/wood{
	dir = 4
	},
/turf/open/floor/wood/parquet,
/area/space)
"zp" = (
/obj/effect/turf_decal/siding/thinplating/dark{
	dir = 6
	},
/turf/open/floor/wood/parquet,
/area/space)
"zt" = (
/obj/effect/turf_decal/siding/thinplating/dark{
	dir = 9
	},
/turf/open/floor/wood/parquet,
/area/space)
"zG" = (
/obj/effect/turf_decal/siding/thinplating/dark/corner{
	dir = 4
	},
/obj/effect/turf_decal/siding/thinplating/dark{
	dir = 8
	},
/turf/open/floor/wood/parquet,
/area/space)
"zM" = (
/obj/structure/chair/sofa/corner{
	dir = 4
	},
/turf/open/floor/mineral/plastitanium/red,
/area/space)
"Aj" = (
/obj/effect/turf_decal/siding/thinplating/dark,
/turf/open/floor/wood/parquet,
/area/space)
"Ak" = (
/turf/open/floor/wood/parquet,
/area/space)
"AQ" = (
/obj/structure/railing{
	dir = 1
	},
/turf/open/floor/iron/stairs/left{
	dir = 8
	},
/area/space)
"Cl" = (
/turf/open/floor/mineral/plastitanium/red,
/area/space)
"De" = (
/obj/effect/turf_decal/siding/thinplating/dark{
	dir = 1
	},
/turf/open/floor/wood/parquet,
/area/space)
"Du" = (
/obj/structure/railing/corner{
	dir = 4
	},
/turf/open/floor/vault{
	desc = "Space tarmac, for space roads.";
	name = "garage floor"
	},
/area/space)
"DS" = (
/obj/effect/turf_decal/siding/thinplating/dark{
	dir = 10
	},
/turf/open/floor/wood/parquet,
/area/space)
"Ep" = (
/obj/structure/chair/sofa/right{
	dir = 1
	},
/turf/open/floor/mineral/plastitanium/red,
/area/space)
"Ew" = (
/obj/effect/turf_decal/siding/thinplating/dark/corner{
	dir = 1
	},
/obj/effect/turf_decal/siding/thinplating/dark{
	dir = 4
	},
/turf/open/floor/wood/parquet,
/area/space)
"FU" = (
/obj/effect/turf_decal/siding/thinplating/dark,
/obj/effect/turf_decal/siding/thinplating/dark{
	dir = 1
	},
/turf/open/floor/wood/parquet,
/area/space)
"FV" = (
/obj/effect/turf_decal/siding/white{
	dir = 8
	},
/turf/open/floor/vault{
	desc = "Space tarmac, for space roads.";
	name = "garage floor"
	},
/area/space)
"Ho" = (
/obj/effect/spawner/structure/window/plasma/reinforced/plastitanium,
/turf/open/space/basic,
/area/space)
"Jk" = (
/obj/machinery/door/airlock/maintenance/external{
	name = "Garage"
	},
/turf/open/floor/iron/smooth,
/area/space)
"JN" = (
/turf/open/floor/mineral/plastitanium,
/area/space)
"OB" = (
/obj/structure/chair/wood{
	dir = 8
	},
/turf/open/floor/wood/parquet,
/area/space)
"Pq" = (
/obj/structure/chair/sofa/right,
/turf/open/floor/mineral/plastitanium/red,
/area/space)
"Ps" = (
/turf/open/floor/iron/smooth,
/area/space)
"PM" = (
/obj/machinery/vending/cigarette{
	desc = "Best cigarettes in all galaxy, guaranteed!";
	initial_language_holder = /datum/language_holder/space_russian;
	name = "\improper Moscow Quality Cigarettes"
	},
/obj/effect/turf_decal/siding/thinplating/dark{
	dir = 6
	},
/turf/open/floor/wood/parquet,
/area/space)
"Qy" = (
/obj/structure/table/wood/poker,
/turf/open/floor/wood/parquet,
/area/space)
"Ra" = (
/obj/effect/turf_decal/siding/white{
	dir = 4
	},
/turf/open/floor/vault{
	desc = "Space tarmac, for space roads.";
	name = "garage floor"
	},
/area/space)
"Rn" = (
/obj/structure/chair/sofa/corner{
	dir = 8
	},
/turf/open/floor/mineral/plastitanium/red,
/area/space)
"Rw" = (
/obj/structure/chair/sofa/left,
/turf/open/floor/mineral/plastitanium/red,
/area/space)
"RV" = (
/obj/effect/decal/hammerandsickle{
	dir = 4
	},
/turf/open/floor/mineral/plastitanium/red,
/area/space)
"SP" = (
/obj/structure/chair/sofa/left{
	dir = 1
	},
/turf/open/floor/mineral/plastitanium/red,
/area/space)
"Tf" = (
/obj/structure/chair/sofa{
	dir = 8
	},
/turf/open/floor/mineral/plastitanium/red,
/area/space)
"Ub" = (
/obj/effect/turf_decal/siding/thinplating/dark{
	dir = 4
	},
/obj/effect/turf_decal/siding/thinplating/dark{
	dir = 8
	},
/turf/open/floor/wood/parquet,
/area/space)
"UZ" = (
/obj/machinery/vending/boozeomat/all_access,
/turf/open/floor/mineral/plastitanium,
/area/space)
"Zn" = (
/obj/structure/showcase/machinery/jukebox/russian,
/turf/open/floor/mineral/plastitanium/red,
/area/space)
"ZA" = (
/obj/structure/showcase/russian_car,
/turf/open/floor/vault{
	desc = "Space tarmac, for space roads.";
	name = "garage floor"
	},
/area/space)

(1,1,1) = {"
wb
wb
wb
wb
wb
wb
wb
wb
wb
wb
wb
wb
wb
wb
wb
wb
wb
wb
wb
wb
wb
wb
wb
wb
wb
wb
wb
wb
wb
wb
wb
wb
wb
wb
wb
wb
wb
wb
wb
wb
wb
wb
wb
wb
wb
wb
wb
wb
wb
wb
"}
(2,1,1) = {"
wb
wb
wb
wb
wb
wb
wb
wb
wb
wb
wb
wb
wb
wb
wb
wb
wb
wb
wb
wb
wb
wb
wb
wb
wb
wb
wb
wb
wb
wb
wb
wb
wb
wb
wb
wb
wb
wb
wb
wb
wb
wb
wb
wb
wb
wb
wb
wb
wb
wb
"}
(3,1,1) = {"
wb
wb
wb
wb
wb
wb
wb
wb
wb
wb
wb
wb
wb
wb
wb
wb
wb
wb
wb
wb
wb
wb
wb
wb
wb
wb
wb
wb
wb
wb
wb
wb
wb
wb
wb
wb
wb
wb
wb
wb
wb
wb
wb
wb
wb
wb
wb
wb
wb
wb
"}
(4,1,1) = {"
wb
wb
wb
wb
wb
wb
wb
wb
wb
wb
wb
wb
wb
wb
wb
wb
wb
wb
wb
wb
wb
wb
wb
wb
wb
wb
wb
wb
wb
wb
wb
wb
wb
wb
wb
wb
wb
wb
wb
wb
wb
wb
wb
wb
wb
wb
wb
wb
wb
wb
"}
(5,1,1) = {"
wb
wb
wb
wb
wb
wb
wb
wb
wb
wb
wb
wb
wb
wb
wb
wb
wb
wb
wb
wb
wb
wb
wb
wb
wb
wb
wb
wb
wb
wb
wb
wb
wb
wb
wb
wb
wb
wb
wb
wb
wb
wb
wb
wb
wb
wb
wb
wb
wb
wb
"}
(6,1,1) = {"
wb
wb
wb
wb
wb
wb
wb
wb
wb
wb
wb
wb
wb
wb
wb
wb
wb
wb
wb
wb
wb
wb
wb
wb
wb
wb
wb
wb
wb
wb
wb
wb
wb
wb
wb
wb
wb
wb
wb
wb
wb
wb
wb
wb
wb
wb
wb
wb
wb
wb
"}
(7,1,1) = {"
wb
wb
wb
wb
wb
wb
wb
wb
wb
wb
wb
wb
wb
wb
wb
wb
wb
wb
wb
wb
wb
wb
wb
wb
wb
wb
wb
wb
wb
wb
wb
wb
wb
wb
wb
wb
wb
wb
wb
wb
wb
wb
wb
wb
wb
wb
wb
wb
wb
wb
"}
(8,1,1) = {"
wb
wb
wb
wb
wb
wb
wb
wb
wb
wb
wb
wb
wb
wb
wb
wb
wb
wb
wb
wb
wb
wb
wb
wb
wb
wb
wb
wb
wb
wb
wb
wb
wb
wb
wb
wb
wb
hN
hN
hN
hN
hN
hN
wb
wb
wb
wb
wb
wb
wb
"}
(9,1,1) = {"
wb
wb
wb
wb
wb
wb
wb
wb
wb
wb
wb
wb
wb
wb
wb
wb
wb
wb
wb
wb
wb
wb
wb
wb
wb
wb
wb
wb
wb
wb
wb
wb
wb
wb
wb
wb
hN
hN
sE
sE
sE
sE
hN
hN
hN
hN
hN
hN
wb
wb
"}
(10,1,1) = {"
wb
wb
wb
wb
wb
wb
wb
wb
wb
wb
wb
wb
wb
wb
wb
wb
wb
wb
wb
wb
wb
wb
wb
wb
wb
wb
wb
wb
wb
wb
wb
Ak
Ak
Ak
Ak
Ak
hN
sE
sE
sE
ZA
sE
sE
sE
sE
sE
sE
sE
wb
wb
"}
(11,1,1) = {"
wb
wb
wb
wb
wb
wb
wb
wb
wb
wb
wb
wb
wb
wb
wb
wb
wb
wb
wb
wb
wb
wb
wb
wb
wb
wb
wb
wb
wb
wb
wb
Ak
Ak
Ak
Ak
Ak
hN
FV
FV
FV
FV
FV
FV
FV
FV
FV
FV
FV
wb
wb
"}
(12,1,1) = {"
wb
wb
wb
wb
wb
wb
wb
wb
wb
wb
wb
wb
wb
wb
wb
hN
hN
hN
hN
hN
hN
hN
wb
wb
wb
wb
wb
wb
wb
wb
wb
Ak
he
he
he
Ak
hN
Ra
Ra
Ra
Ra
Ra
Ra
Ra
Ra
Ra
Ra
Ra
wb
wb
"}
(13,1,1) = {"
wb
wb
wb
wb
wb
wb
wb
wb
wb
wb
wb
wb
wb
wb
wb
zt
kT
kT
kT
DS
dh
hN
hN
hN
wb
wb
wb
wb
wb
wb
wb
Ak
he
he
he
Ak
hN
sE
sE
sE
sE
sE
sE
sE
sE
sE
sE
sE
wb
wb
"}
(14,1,1) = {"
wb
wb
wb
wb
wb
wb
wb
wb
wb
wb
wb
wb
wb
wb
wb
De
Qy
Qy
Qy
wE
DS
wb
wb
wb
wb
wb
wb
wb
wb
wb
wb
Ak
Cl
cH
Cl
Ak
hN
sE
sE
sE
sE
sE
hN
hN
hN
hN
hN
hN
wb
wb
"}
(15,1,1) = {"
wb
wb
wb
wb
wb
wb
wb
wb
wb
wb
wb
wb
wb
wb
wb
De
Qy
Qy
Qy
ac
zp
hN
hN
hN
wb
wb
wb
wb
wb
wb
wb
Ak
he
he
he
Ak
hN
sE
sE
sE
ZA
sE
sE
sE
sE
sE
sE
sE
wb
wb
"}
(16,1,1) = {"
wb
wb
wb
wb
wb
wb
wb
wb
wb
wb
wb
wb
wb
wb
wb
De
Ak
Ak
Ak
Aj
uK
pQ
wb
wb
wb
wb
wb
wb
wb
wb
wb
Ak
he
he
he
Ak
hN
FV
FV
FV
FV
FV
FV
FV
FV
FV
FV
FV
wb
wb
"}
(17,1,1) = {"
wb
wb
wb
wb
wb
wb
wb
wb
wb
wb
wb
wb
wb
wb
wb
De
Cl
Cl
Cl
Aj
eK
eK
wb
wb
wb
wb
wb
wb
wb
wb
wb
Ak
Ak
Ak
Ak
Ak
hN
Ra
Ra
Ra
Ra
Ra
Ra
Ra
Ra
Ra
Ra
Ra
wb
wb
"}
(18,1,1) = {"
wb
wb
wb
wb
wb
wb
wb
wb
wb
wb
wb
wb
wb
wb
wb
De
Cl
Cl
Cl
Aj
hQ
uf
wb
wb
wb
wb
wb
wb
wb
wb
wb
Ak
Ak
Ak
Ak
Ak
hN
sE
sE
sE
sE
sE
sE
sE
sE
sE
sE
sE
wb
wb
"}
(19,1,1) = {"
wb
wb
wb
wb
wb
wb
wb
wb
wb
wb
wb
wb
wb
wb
wb
De
Cl
cH
Cl
Aj
Cl
Zn
hN
wb
wb
wb
wb
hN
hN
hN
hN
JN
hN
hN
hN
Cl
hN
hN
qL
qL
Du
gU
hN
hN
hN
hN
hN
hN
wb
wb
"}
(20,1,1) = {"
wb
wb
wb
wb
wb
wb
wb
wb
wb
wb
wb
wb
wb
wb
wb
De
Cl
Cl
Cl
Aj
uK
pQ
wb
wb
wb
wb
wb
hN
UZ
ah
ah
JN
JN
hN
Cl
Cl
Cl
hN
Ps
Ps
AQ
cQ
hN
wb
wb
wb
wb
wb
wb
wb
"}
(21,1,1) = {"
wb
wb
wb
wb
wb
wb
wb
wb
wb
wb
wb
wb
wb
wb
wb
De
Cl
Cl
Cl
Aj
eK
eK
wb
wb
wb
wb
wb
JN
JN
JN
JN
JN
JN
JN
Cl
Cl
Cl
Jk
Ps
Ps
Ps
Ps
hN
wb
wb
wb
wb
wb
wb
wb
"}
(22,1,1) = {"
wb
wb
wb
wb
wb
wb
wb
wb
wb
wb
wb
wb
wb
wb
wb
pZ
ko
ko
ko
zp
hQ
uf
wb
wb
wb
wb
wb
hN
JN
JN
JN
JN
JN
hN
Cl
Cl
Cl
hN
Ps
Ps
Ps
Ps
hN
wb
wb
wb
wb
wb
wb
wb
"}
(23,1,1) = {"
wb
wb
wb
wb
wb
wb
wb
wb
wb
wb
wb
wb
wb
wb
wb
Pq
eK
eK
eK
SP
hN
hN
hN
wb
hN
hN
hN
hN
ah
ah
ah
ah
ah
hN
hN
Cl
hN
hN
hN
hN
hN
hN
hN
wb
wb
wb
wb
wb
wb
wb
"}
(24,1,1) = {"
wb
wb
wb
wb
wb
wb
wb
wb
wb
wb
wb
wb
wb
wb
wb
nL
Tf
Tf
Tf
Rn
hN
wb
wb
wb
hN
zM
pQ
gt
Ub
Ub
Ub
Ub
Ub
zG
kT
kT
DS
hN
wb
wb
wb
wb
wb
wb
wb
wb
wb
wb
wb
wb
"}
(25,1,1) = {"
wb
wb
wb
wb
wb
wb
wb
wb
wb
wb
wb
wb
wb
wb
wb
wb
wb
wb
wb
wb
wb
wb
wb
wb
hN
sn
eK
FU
Cl
Cl
Cl
Cl
Cl
De
yg
yg
Aj
Ho
wb
wb
wb
wb
wb
wb
wb
wb
wb
wb
wb
wb
"}
(26,1,1) = {"
wb
wb
wb
wb
wb
wb
wb
wb
wb
wb
wb
wb
wb
wb
wb
wb
wb
wb
wb
wb
wb
wb
wb
wb
hN
sn
eK
FU
Cl
Cl
RV
Cl
Cl
De
lq
lq
Aj
Ho
wb
wb
wb
wb
wb
wb
wb
wb
wb
wb
wb
wb
"}
(27,1,1) = {"
wb
wb
wb
wb
wb
wb
wb
wb
wb
wb
wb
wb
wb
wb
wb
wb
wb
wb
wb
wb
wb
wb
wb
wb
hN
sn
eK
FU
Cl
Cl
Cl
Cl
Cl
De
OB
OB
Aj
Ho
wb
wb
wb
wb
wb
wb
wb
wb
wb
wb
wb
wb
"}
(28,1,1) = {"
wb
wb
wb
wb
wb
wb
wb
wb
wb
wb
wb
wb
wb
wb
wb
wb
wb
wb
wb
wb
wb
wb
wb
wb
hN
nL
uf
oH
ra
ra
ra
ra
ra
Ew
rB
Ak
Aj
Ho
wb
wb
wb
wb
wb
wb
wb
wb
wb
wb
wb
wb
"}
(29,1,1) = {"
wb
wb
wb
wb
wb
wb
wb
wb
wb
wb
wb
wb
wb
wb
wb
wb
wb
wb
wb
wb
wb
wb
wb
wb
hN
hN
hN
Pq
eK
SP
Cl
Pq
eK
SP
pZ
ko
PM
hN
wb
wb
wb
wb
wb
wb
wb
wb
wb
wb
wb
wb
"}
(30,1,1) = {"
wb
wb
wb
wb
wb
wb
wb
wb
wb
wb
wb
wb
wb
wb
wb
wb
wb
wb
wb
wb
wb
wb
wb
wb
wb
wb
hN
Rw
eK
Ep
Zn
Rw
eK
Ep
hN
Cl
hN
hN
wb
wb
wb
wb
wb
wb
wb
wb
wb
wb
wb
wb
"}
(31,1,1) = {"
wb
wb
wb
wb
wb
wb
wb
wb
wb
wb
wb
wb
wb
wb
wb
wb
wb
wb
wb
wb
wb
wb
wb
wb
wb
wb
hN
Ho
Ho
Ho
hN
Ho
Ho
Ho
hN
Cl
hN
wb
wb
wb
wb
wb
wb
wb
wb
wb
wb
wb
wb
wb
"}
(32,1,1) = {"
wb
wb
wb
wb
wb
wb
wb
wb
wb
wb
wb
wb
wb
wb
wb
wb
wb
wb
wb
wb
wb
wb
wb
wb
wb
wb
wb
wb
wb
wb
wb
wb
wb
wb
hN
Cl
hN
wb
wb
wb
wb
wb
wb
wb
wb
wb
wb
wb
wb
wb
"}
(33,1,1) = {"
wb
wb
wb
wb
wb
wb
wb
wb
wb
wb
wb
wb
wb
wb
wb
wb
wb
wb
wb
wb
wb
wb
wb
wb
wb
wb
wb
wb
wb
wb
wb
wb
wb
wb
wb
wb
wb
wb
wb
wb
wb
wb
wb
wb
wb
wb
wb
wb
wb
wb
"}
(34,1,1) = {"
wb
wb
wb
wb
wb
wb
wb
wb
wb
wb
wb
wb
wb
wb
wb
wb
wb
wb
wb
wb
wb
wb
wb
wb
wb
wb
wb
wb
wb
wb
wb
wb
wb
wb
wb
wb
wb
wb
wb
wb
wb
wb
wb
wb
wb
wb
wb
wb
wb
wb
"}
(35,1,1) = {"
wb
wb
wb
wb
wb
wb
wb
wb
wb
wb
wb
wb
wb
wb
wb
wb
wb
wb
wb
wb
wb
wb
wb
wb
wb
wb
wb
wb
wb
wb
wb
wb
wb
wb
wb
wb
wb
wb
wb
wb
wb
wb
wb
wb
wb
wb
wb
wb
wb
wb
"}
(36,1,1) = {"
wb
wb
wb
wb
wb
wb
wb
wb
wb
wb
wb
wb
wb
wb
wb
wb
wb
wb
wb
wb
wb
wb
wb
wb
wb
wb
wb
wb
wb
wb
wb
wb
wb
wb
wb
wb
wb
wb
wb
wb
wb
wb
wb
wb
wb
wb
wb
wb
wb
wb
"}
(37,1,1) = {"
wb
wb
wb
wb
wb
wb
wb
wb
wb
wb
wb
wb
wb
wb
wb
wb
wb
wb
wb
wb
wb
wb
wb
wb
wb
wb
wb
wb
wb
wb
wb
wb
wb
wb
wb
wb
wb
wb
wb
wb
wb
wb
wb
wb
wb
wb
wb
wb
wb
wb
"}
(38,1,1) = {"
wb
wb
wb
wb
wb
wb
wb
wb
wb
wb
wb
wb
wb
wb
wb
wb
wb
wb
wb
wb
wb
wb
wb
wb
wb
wb
wb
wb
wb
wb
wb
wb
wb
wb
wb
wb
wb
wb
wb
wb
wb
wb
wb
wb
wb
wb
wb
wb
wb
wb
"}
(39,1,1) = {"
wb
wb
wb
wb
wb
wb
wb
wb
wb
wb
wb
wb
wb
wb
wb
wb
wb
wb
wb
wb
wb
wb
wb
wb
wb
wb
wb
wb
wb
wb
wb
wb
wb
wb
wb
wb
wb
wb
wb
wb
wb
wb
wb
wb
wb
wb
wb
wb
wb
wb
"}
(40,1,1) = {"
wb
wb
wb
wb
wb
wb
wb
wb
wb
wb
wb
wb
wb
wb
wb
wb
wb
wb
wb
wb
wb
wb
wb
wb
wb
wb
wb
wb
wb
wb
wb
wb
wb
wb
wb
wb
wb
wb
wb
wb
wb
wb
wb
wb
wb
wb
wb
wb
wb
wb
"}
(41,1,1) = {"
wb
wb
wb
wb
wb
wb
wb
wb
wb
wb
wb
wb
wb
wb
wb
wb
wb
wb
wb
wb
wb
wb
wb
wb
wb
wb
wb
wb
wb
wb
wb
wb
wb
wb
wb
wb
wb
wb
wb
wb
wb
wb
wb
wb
wb
wb
wb
wb
wb
wb
"}
(42,1,1) = {"
wb
wb
wb
wb
wb
wb
wb
wb
wb
wb
wb
wb
wb
wb
wb
wb
wb
wb
wb
wb
wb
wb
wb
wb
wb
wb
wb
wb
wb
wb
wb
wb
wb
wb
wb
wb
wb
wb
wb
wb
wb
wb
wb
wb
wb
wb
wb
wb
wb
wb
"}
(43,1,1) = {"
wb
wb
wb
wb
wb
wb
wb
wb
wb
wb
wb
wb
wb
wb
wb
wb
wb
wb
wb
wb
wb
wb
wb
wb
wb
wb
wb
wb
wb
wb
wb
wb
wb
wb
wb
wb
wb
wb
wb
wb
wb
wb
wb
wb
wb
wb
wb
wb
wb
wb
"}
(44,1,1) = {"
wb
wb
wb
wb
wb
wb
wb
wb
wb
wb
wb
wb
wb
wb
wb
wb
wb
wb
wb
wb
wb
wb
wb
wb
wb
wb
wb
wb
wb
wb
wb
wb
wb
wb
wb
wb
wb
wb
wb
wb
wb
wb
wb
wb
wb
wb
wb
wb
wb
wb
"}
(45,1,1) = {"
wb
wb
wb
wb
wb
wb
wb
wb
wb
wb
wb
wb
wb
wb
wb
wb
wb
wb
wb
wb
wb
wb
wb
wb
wb
wb
wb
wb
wb
wb
wb
wb
wb
wb
wb
wb
wb
wb
wb
wb
wb
wb
wb
wb
wb
wb
wb
wb
wb
wb
"}
(46,1,1) = {"
wb
wb
wb
wb
wb
wb
wb
wb
wb
wb
wb
wb
wb
wb
wb
wb
wb
wb
wb
wb
wb
wb
wb
wb
wb
wb
wb
wb
wb
wb
wb
wb
wb
wb
wb
wb
wb
wb
wb
wb
wb
wb
wb
wb
wb
wb
wb
wb
wb
wb
"}
(47,1,1) = {"
wb
wb
wb
wb
wb
wb
wb
wb
wb
wb
wb
wb
wb
wb
wb
wb
wb
wb
wb
wb
wb
wb
wb
wb
wb
wb
wb
wb
wb
wb
wb
wb
wb
wb
wb
wb
wb
wb
wb
wb
wb
wb
wb
wb
wb
wb
wb
wb
wb
wb
"}
(48,1,1) = {"
wb
wb
wb
wb
wb
wb
wb
wb
wb
wb
wb
wb
wb
wb
wb
wb
wb
wb
wb
wb
wb
wb
wb
wb
wb
wb
wb
wb
wb
wb
wb
wb
wb
wb
wb
wb
wb
wb
wb
wb
wb
wb
wb
wb
wb
wb
wb
wb
wb
wb
"}
(49,1,1) = {"
wb
wb
wb
wb
wb
wb
wb
wb
wb
wb
wb
wb
wb
wb
wb
wb
wb
wb
wb
wb
wb
wb
wb
wb
wb
wb
wb
wb
wb
wb
wb
wb
wb
wb
wb
wb
wb
wb
wb
wb
wb
wb
wb
wb
wb
wb
wb
wb
wb
wb
"}
(50,1,1) = {"
wb
wb
wb
wb
wb
wb
wb
wb
wb
wb
wb
wb
wb
wb
wb
wb
wb
wb
wb
wb
wb
wb
wb
wb
wb
wb
wb
wb
wb
wb
wb
wb
wb
wb
wb
wb
wb
wb
wb
wb
wb
wb
wb
wb
wb
wb
wb
wb
wb
wb
"}
