//MAP CONVERTED BY dmm2tgm.py THIS HEADER COMMENT PREVENTS RECONVERSION, DO NOT REMOVE
"ac" = (
/obj/effect/turf_decal/siding/thinplating/dark/corner,
/turf/open/floor/wood/parquet,
/area/space)
"ah" = (
/obj/structure/table/reinforced/plastitaniumglass,
/turf/open/floor/mineral/plastitanium,
/area/space)
"aX" = (
/obj/item/kirbyplants{
	icon_state = "plant-02"
	},
/turf/open/floor/wood/parquet,
/area/space)
"bF" = (
/obj/structure/closet/crate/bin,
/obj/effect/turf_decal/tile/dark,
/obj/effect/turf_decal/tile/dark{
	dir = 1
	},
/obj/effect/turf_decal/tile/neutral{
	dir = 8
	},
/obj/effect/turf_decal/tile/neutral{
	dir = 4
	},
/turf/open/floor/iron/smooth,
/area/space)
"cH" = (
/obj/effect/decal/hammerandsickle,
/turf/open/floor/mineral/plastitanium/red,
/area/space)
"cQ" = (
/obj/structure/railing,
/turf/open/floor/iron/stairs/right{
	dir = 8
	},
/area/space)
"dh" = (
/obj/machinery/vending/cigarette/russian,
/turf/open/floor/mineral/plastitanium/red,
/area/space)
"dC" = (
/obj/structure/table/reinforced,
/obj/item/wrench,
/obj/structure/cable,
/turf/open/floor/iron/smooth,
/area/space)
"el" = (
/turf/open/floor/iron/stairs/old,
/area/space)
"eI" = (
/obj/machinery/door/airlock/maintenance/external{
	name = "Bathroom"
	},
/turf/open/floor/iron/smooth,
/area/space)
"eK" = (
/obj/structure/table/wood,
/turf/open/floor/mineral/plastitanium/red,
/area/space)
"fu" = (
/obj/structure/table/wood,
/turf/open/floor/iron/smooth,
/area/space)
"fL" = (
/obj/structure/urinal/directional/east,
/obj/item/food/urinalcake,
/turf/open/floor/iron/smooth,
/area/space)
"gK" = (
/obj/machinery/door/airlock/maintenance/external{
	name = "Kitchen"
	},
/turf/open/floor/iron/smooth,
/area/space)
"gU" = (
/obj/structure/railing/corner,
/turf/open/floor/vault{
	desc = "Space tarmac, for space roads.";
	name = "garage floor"
	},
/area/space)
"he" = (
/obj/machinery/door/poddoor,
/turf/open/floor/vault{
	desc = "Space tarmac, for space roads.";
	name = "garage floor"
	},
/area/space)
"hN" = (
/turf/closed/wall,
/area/space)
"hQ" = (
/obj/structure/chair/sofa/right{
	dir = 8
	},
/turf/open/floor/mineral/plastitanium/red,
/area/space)
"ij" = (
/obj/effect/turf_decal/siding/thinplating/dark{
	dir = 5
	},
/obj/effect/turf_decal/siding/thinplating/dark/corner{
	dir = 8
	},
/turf/open/floor/wood/parquet,
/area/space)
"iH" = (
/obj/structure/closet/secure_closet/freezer/fridge,
/obj/effect/turf_decal/tile/dark,
/obj/effect/turf_decal/tile/dark{
	dir = 1
	},
/obj/effect/turf_decal/tile/neutral{
	dir = 8
	},
/obj/effect/turf_decal/tile/neutral{
	dir = 4
	},
/turf/open/floor/iron/smooth,
/area/space)
"ke" = (
/obj/structure/urinal/directional/east,
/turf/open/floor/iron/smooth,
/area/space)
"ko" = (
/obj/effect/turf_decal/siding/thinplating/dark{
	dir = 4
	},
/turf/open/floor/wood/parquet,
/area/space)
"kT" = (
/obj/effect/turf_decal/siding/thinplating/dark{
	dir = 8
	},
/turf/open/floor/wood/parquet,
/area/space)
"kY" = (
/obj/structure/toilet{
	pixel_y = 8
	},
/turf/open/floor/iron/smooth,
/area/space)
"lq" = (
/obj/structure/table/wood,
/turf/open/floor/wood/parquet,
/area/space)
"lQ" = (
/obj/item/storage/toolbox/electrical,
/turf/open/floor/iron/smooth,
/area/space)
"nL" = (
/obj/structure/chair/sofa/corner,
/turf/open/floor/mineral/plastitanium/red,
/area/space)
"pQ" = (
/obj/structure/chair/sofa/right{
	dir = 4
	},
/turf/open/floor/mineral/plastitanium/red,
/area/space)
"pZ" = (
/obj/effect/turf_decal/tile/dark,
/obj/effect/turf_decal/tile/dark{
	dir = 1
	},
/obj/effect/turf_decal/tile/neutral{
	dir = 8
	},
/obj/effect/turf_decal/tile/neutral{
	dir = 4
	},
/obj/structure/sink/kitchen{
	pixel_y = 14
	},
/turf/open/floor/iron/smooth,
/area/space)
"qf" = (
/obj/effect/turf_decal/siding/thinplating/dark{
	dir = 1
	},
/obj/effect/turf_decal/siding/thinplating/dark,
/turf/open/floor/wood/parquet,
/area/space)
"qy" = (
/obj/machinery/oven,
/obj/effect/turf_decal/tile/dark,
/obj/effect/turf_decal/tile/dark{
	dir = 1
	},
/obj/effect/turf_decal/tile/neutral{
	dir = 8
	},
/obj/effect/turf_decal/tile/neutral{
	dir = 4
	},
/turf/open/floor/iron/smooth,
/area/space)
"qL" = (
/obj/structure/railing{
	dir = 4
	},
/turf/open/floor/vault{
	desc = "Space tarmac, for space roads.";
	name = "garage floor"
	},
/area/space)
"ra" = (
/obj/machinery/door/airlock/maintenance/external{
	name = "Pravda Bar"
	},
/turf/open/floor/mineral/plastitanium/red,
/area/space)
"rL" = (
/obj/item/kirbyplants{
	icon_state = "plant-02"
	},
/turf/open/floor/iron/smooth,
/area/space)
"rM" = (
/obj/effect/turf_decal/tile/dark,
/obj/effect/turf_decal/tile/dark{
	dir = 1
	},
/obj/effect/turf_decal/tile/neutral{
	dir = 8
	},
/obj/effect/turf_decal/tile/neutral{
	dir = 4
	},
/turf/open/floor/iron/smooth,
/area/space)
"sE" = (
/turf/open/floor/vault{
	desc = "Space tarmac, for space roads.";
	name = "garage floor"
	},
/area/space)
"sT" = (
/obj/structure/rack,
/turf/open/floor/iron/smooth,
/area/space)
"uf" = (
/obj/structure/chair/sofa/left{
	dir = 8
	},
/turf/open/floor/mineral/plastitanium/red,
/area/space)
"uK" = (
/obj/structure/chair/sofa/left{
	dir = 4
	},
/turf/open/floor/mineral/plastitanium/red,
/area/space)
"vq" = (
/obj/effect/spawner/structure/window/reinforced,
/turf/open/floor/plating,
/area/space)
"vY" = (
/obj/structure/closet/crate/trashcart/filled,
/turf/open/floor/plating/asteroid/airless,
/area/space)
"wb" = (
/turf/open/space/basic,
/area/space)
"wE" = (
/obj/effect/turf_decal/siding/thinplating/dark/corner{
	dir = 8
	},
/turf/open/floor/wood/parquet,
/area/space)
"xC" = (
/turf/open/floor/plating/asteroid/airless,
/area/space)
"zp" = (
/obj/effect/turf_decal/siding/thinplating/dark{
	dir = 6
	},
/turf/open/floor/wood/parquet,
/area/space)
"zt" = (
/obj/effect/turf_decal/siding/thinplating/dark{
	dir = 9
	},
/turf/open/floor/wood/parquet,
/area/space)
"Ai" = (
/obj/structure/table/reinforced,
/obj/effect/turf_decal/tile/dark,
/obj/effect/turf_decal/tile/dark{
	dir = 1
	},
/obj/effect/turf_decal/tile/neutral{
	dir = 8
	},
/obj/effect/turf_decal/tile/neutral{
	dir = 4
	},
/obj/item/plate/oven_tray,
/turf/open/floor/iron/smooth,
/area/space)
"Ak" = (
/turf/open/floor/wood/parquet,
/area/space)
"AQ" = (
/obj/structure/railing{
	dir = 1
	},
/turf/open/floor/iron/stairs/left{
	dir = 8
	},
/area/space)
"AU" = (
/obj/machinery/door/airlock/maintenance/external{
	name = "Bar Backroom"
	},
/turf/open/floor/iron/smooth,
/area/space)
"Bb" = (
/obj/structure/bookcase,
/obj/structure/sign/painting/library_private{
	pixel_y = 32
	},
/turf/open/floor/wood/parquet,
/area/space)
"Bu" = (
/obj/structure/kitchenspike,
/obj/effect/mob_spawn/human/corpse/damaged,
/obj/effect/decal/cleanable/blood,
/turf/open/floor/iron/kitchen_coldroom/freezerfloor,
/area/space)
"BM" = (
/obj/machinery/door/airlock/maintenance/external{
	name = "Stall"
	},
/turf/open/floor/iron/smooth,
/area/space)
"Ch" = (
/obj/machinery/door/airlock/maintenance/external{
	name = "Storage"
	},
/obj/effect/mapping_helpers/airlock/locked,
/turf/open/floor/iron/smooth,
/area/space)
"Cl" = (
/turf/open/floor/mineral/plastitanium/red,
/area/space)
"De" = (
/obj/effect/turf_decal/siding/thinplating/dark{
	dir = 1
	},
/turf/open/floor/wood/parquet,
/area/space)
"Dm" = (
/obj/structure/table/reinforced,
/turf/open/floor/iron/smooth,
/area/space)
"Du" = (
/obj/structure/railing/corner{
	dir = 4
	},
/turf/open/floor/vault{
	desc = "Space tarmac, for space roads.";
	name = "garage floor"
	},
/area/space)
"Dv" = (
/obj/structure/chair{
	dir = 1
	},
/turf/open/floor/mineral/plastitanium/red,
/area/space)
"DB" = (
/obj/structure/chair/comfy,
/obj/structure/safe/floor,
/turf/open/floor/wood/parquet,
/area/space)
"DS" = (
/obj/effect/turf_decal/siding/thinplating/dark{
	dir = 10
	},
/turf/open/floor/wood/parquet,
/area/space)
"EB" = (
/obj/effect/turf_decal/tile/dark,
/obj/effect/turf_decal/tile/dark{
	dir = 1
	},
/obj/effect/turf_decal/tile/neutral{
	dir = 8
	},
/obj/effect/turf_decal/tile/neutral{
	dir = 4
	},
/obj/machinery/door/airlock/maintenance/external{
	name = "Freezer"
	},
/obj/effect/mapping_helpers/airlock/locked,
/turf/open/floor/iron/smooth,
/area/space)
"Fc" = (
/obj/item/kirbyplants,
/turf/open/floor/wood/parquet,
/area/space)
"Fz" = (
/obj/structure/railing,
/turf/open/floor/iron/smooth,
/area/space)
"FU" = (
/obj/effect/turf_decal/siding/thinplating/dark,
/obj/effect/turf_decal/siding/thinplating/dark{
	dir = 1
	},
/turf/open/floor/wood/parquet,
/area/space)
"FV" = (
/obj/effect/turf_decal/siding/white{
	dir = 8
	},
/turf/open/floor/vault{
	desc = "Space tarmac, for space roads.";
	name = "garage floor"
	},
/area/space)
"IR" = (
/obj/effect/turf_decal/siding/thinplating/dark{
	dir = 1
	},
/obj/structure/chair/stool/bar/directional/south,
/obj/effect/turf_decal/siding/thinplating/dark,
/turf/open/floor/wood/parquet,
/area/space)
"IS" = (
/obj/effect/turf_decal/siding/thinplating/dark{
	dir = 1
	},
/obj/effect/turf_decal/siding/thinplating/dark/corner,
/turf/open/floor/wood/parquet,
/area/space)
"Jk" = (
/obj/machinery/door/airlock/maintenance/external{
	name = "Garage"
	},
/turf/open/floor/iron/smooth,
/area/space)
"JN" = (
/turf/open/floor/mineral/plastitanium,
/area/space)
"LR" = (
/obj/structure/table/reinforced,
/obj/machinery/microwave{
	pixel_y = 5
	},
/obj/effect/turf_decal/tile/dark,
/obj/effect/turf_decal/tile/dark{
	dir = 1
	},
/obj/effect/turf_decal/tile/neutral{
	dir = 8
	},
/obj/effect/turf_decal/tile/neutral{
	dir = 4
	},
/turf/open/floor/iron/smooth,
/area/space)
"Mf" = (
/obj/machinery/door/airlock/maintenance/external{
	name = "Maintenance Closet"
	},
/turf/open/floor/iron/smooth,
/area/space)
"Mt" = (
/turf/closed/mineral/asteroid,
/area/space)
"Mx" = (
/obj/structure/table,
/obj/item/wirecutters,
/turf/open/floor/iron/kitchen_coldroom/freezerfloor,
/area/space)
"MO" = (
/obj/effect/turf_decal/siding/white{
	dir = 4
	},
/obj/machinery/door/poddoor,
/turf/open/floor/vault{
	desc = "Space tarmac, for space roads.";
	name = "garage floor"
	},
/area/space)
"NC" = (
/obj/machinery/door/airlock/maintenance/external{
	name = "External Access"
	},
/turf/open/floor/iron/smooth,
/area/space)
"NG" = (
/obj/structure/cable,
/obj/machinery/power/apc/auto_name/north,
/turf/open/floor/iron/smooth,
/area/space)
"OT" = (
/obj/structure/table/wood/poker{
	name = "pool table"
	},
/turf/open/floor/wood/parquet,
/area/space)
"Pq" = (
/obj/structure/chair/sofa/right,
/turf/open/floor/mineral/plastitanium/red,
/area/space)
"Ps" = (
/turf/open/floor/iron/smooth,
/area/space)
"PC" = (
/obj/item/kitchen/knife/butcher,
/turf/open/floor/iron/kitchen_coldroom/freezerfloor,
/area/space)
"PZ" = (
/obj/structure/cable,
/turf/open/floor/iron/smooth,
/area/space)
"QG" = (
/obj/structure/mopbucket,
/obj/item/mop,
/turf/open/floor/iron/smooth,
/area/space)
"Ra" = (
/obj/effect/turf_decal/siding/white{
	dir = 4
	},
/turf/open/floor/vault{
	desc = "Space tarmac, for space roads.";
	name = "garage floor"
	},
/area/space)
"Rn" = (
/obj/structure/chair/sofa/corner{
	dir = 8
	},
/turf/open/floor/mineral/plastitanium/red,
/area/space)
"Rw" = (
/obj/effect/turf_decal/siding/thinplating/dark,
/obj/effect/turf_decal/siding/thinplating/dark/corner{
	dir = 4
	},
/turf/open/floor/wood/parquet,
/area/space)
"RI" = (
/obj/machinery/griddle,
/obj/effect/turf_decal/tile/dark,
/obj/effect/turf_decal/tile/dark{
	dir = 1
	},
/obj/effect/turf_decal/tile/neutral{
	dir = 8
	},
/obj/effect/turf_decal/tile/neutral{
	dir = 4
	},
/turf/open/floor/iron/smooth,
/area/space)
"Sb" = (
/turf/open/floor/plating/catwalk_floor,
/area/space)
"Sc" = (
/obj/effect/turf_decal/siding/thinplating/dark{
	dir = 6
	},
/obj/effect/turf_decal/siding/thinplating/dark/corner{
	dir = 1
	},
/turf/open/floor/wood/parquet,
/area/space)
"Sx" = (
/obj/structure/closet/crate/trashcart,
/turf/open/floor/plating/asteroid/airless,
/area/space)
"SF" = (
/obj/machinery/door/airlock/maintenance/external{
	name = "Custodial Closet"
	},
/turf/open/floor/iron/smooth,
/area/space)
"SP" = (
/obj/structure/chair/sofa/left{
	dir = 1
	},
/turf/open/floor/mineral/plastitanium/red,
/area/space)
"Tf" = (
/obj/structure/chair/sofa{
	dir = 8
	},
/turf/open/floor/mineral/plastitanium/red,
/area/space)
"Tw" = (
/obj/machinery/power/smes,
/obj/structure/cable,
/turf/open/floor/iron/smooth,
/area/space)
"Ub" = (
/obj/effect/turf_decal/siding/thinplating/dark{
	dir = 4
	},
/obj/effect/turf_decal/siding/thinplating/dark{
	dir = 8
	},
/turf/open/floor/wood/parquet,
/area/space)
"US" = (
/turf/open/floor/iron/kitchen_coldroom/freezerfloor,
/area/space)
"UZ" = (
/obj/machinery/vending/boozeomat/all_access,
/turf/open/floor/mineral/plastitanium,
/area/space)
"Vx" = (
/obj/structure/kitchenspike,
/turf/open/floor/iron/kitchen_coldroom/freezerfloor,
/area/space)
"VD" = (
/obj/machinery/atmospherics/components/tank/air,
/turf/open/floor/iron/smooth,
/area/space)
"Wc" = (
/obj/structure/chair{
	dir = 4
	},
/turf/open/floor/iron/smooth,
/area/space)
"Wh" = (
/obj/structure/table/reinforced,
/obj/effect/turf_decal/tile/dark,
/obj/effect/turf_decal/tile/dark{
	dir = 1
	},
/obj/effect/turf_decal/tile/neutral{
	dir = 8
	},
/obj/effect/turf_decal/tile/neutral{
	dir = 4
	},
/turf/open/floor/iron/smooth,
/area/space)
"XA" = (
/obj/machinery/door/airlock/maintenance/external{
	name = "Bar Back"
	},
/turf/open/floor/iron/smooth,
/area/space)
"XC" = (
/obj/effect/turf_decal/siding/white{
	dir = 8
	},
/obj/machinery/door/poddoor,
/turf/open/floor/vault{
	desc = "Space tarmac, for space roads.";
	name = "garage floor"
	},
/area/space)
"YP" = (
/obj/structure/sink/kitchen{
	dir = 4;
	pixel_x = -11
	},
/obj/structure/mirror/directional/west,
/turf/open/floor/iron/smooth,
/area/space)
"Zn" = (
/obj/structure/showcase/machinery/jukebox/russian,
/turf/open/floor/mineral/plastitanium/red,
/area/space)
"ZA" = (
/obj/structure/showcase/russian_car,
/turf/open/floor/vault{
	desc = "Space tarmac, for space roads.";
	name = "garage floor"
	},
/area/space)
"ZX" = (
/obj/structure/bookcase,
/turf/open/floor/wood/parquet,
/area/space)

(1,1,1) = {"
wb
wb
wb
wb
wb
wb
wb
wb
wb
wb
wb
wb
wb
wb
wb
wb
wb
wb
wb
wb
wb
wb
wb
wb
wb
wb
wb
wb
wb
wb
wb
wb
wb
wb
wb
wb
wb
wb
wb
wb
wb
wb
wb
wb
wb
wb
wb
wb
wb
wb
"}
(2,1,1) = {"
wb
wb
wb
wb
wb
wb
wb
wb
wb
wb
wb
wb
wb
wb
wb
wb
wb
wb
wb
wb
wb
wb
wb
wb
wb
wb
wb
wb
wb
wb
wb
wb
wb
wb
wb
wb
wb
wb
wb
wb
wb
wb
wb
wb
wb
wb
wb
wb
wb
wb
"}
(3,1,1) = {"
wb
wb
wb
wb
wb
wb
wb
wb
wb
wb
wb
wb
wb
wb
wb
wb
wb
wb
wb
wb
wb
wb
wb
wb
wb
wb
wb
wb
wb
wb
wb
wb
wb
wb
wb
wb
wb
wb
wb
wb
wb
wb
wb
wb
wb
wb
wb
wb
wb
wb
"}
(4,1,1) = {"
wb
wb
wb
wb
wb
wb
wb
wb
wb
wb
wb
wb
wb
wb
wb
wb
wb
wb
wb
wb
wb
wb
wb
wb
wb
wb
wb
wb
wb
wb
wb
wb
wb
wb
wb
wb
wb
wb
wb
wb
wb
wb
wb
wb
wb
wb
wb
wb
wb
wb
"}
(5,1,1) = {"
wb
wb
wb
wb
wb
wb
wb
wb
wb
wb
wb
wb
wb
wb
wb
wb
wb
wb
wb
wb
wb
wb
wb
wb
wb
wb
wb
wb
wb
wb
wb
wb
wb
wb
wb
wb
wb
wb
wb
wb
wb
wb
wb
wb
wb
wb
wb
wb
wb
wb
"}
(6,1,1) = {"
wb
wb
wb
wb
wb
wb
wb
wb
wb
wb
wb
wb
wb
wb
wb
wb
wb
wb
wb
wb
wb
wb
wb
xC
xC
xC
xC
xC
xC
xC
xC
xC
wb
wb
wb
wb
wb
wb
wb
wb
wb
wb
wb
wb
wb
wb
wb
wb
wb
wb
"}
(7,1,1) = {"
wb
wb
wb
wb
wb
wb
wb
wb
wb
wb
wb
wb
xC
xC
xC
xC
xC
xC
xC
wb
wb
wb
xC
xC
xC
xC
Mt
Mt
Mt
xC
xC
xC
xC
wb
wb
wb
wb
wb
wb
wb
wb
wb
wb
wb
wb
wb
wb
wb
wb
wb
"}
(8,1,1) = {"
wb
wb
wb
wb
wb
wb
wb
wb
wb
wb
wb
xC
xC
xC
xC
xC
xC
xC
xC
xC
xC
xC
xC
Mt
Mt
Mt
Mt
Mt
Mt
Mt
xC
xC
xC
wb
wb
wb
wb
wb
wb
wb
wb
wb
wb
wb
wb
wb
wb
wb
wb
wb
"}
(9,1,1) = {"
wb
wb
wb
wb
wb
wb
wb
wb
wb
wb
wb
xC
Mt
hN
xC
xC
xC
hN
Mt
xC
xC
xC
Mt
Mt
Mt
Mt
Mt
Mt
Mt
Mt
Mt
Mt
xC
xC
wb
wb
wb
wb
wb
wb
wb
wb
wb
wb
wb
wb
wb
wb
wb
wb
"}
(10,1,1) = {"
wb
wb
wb
wb
wb
wb
wb
wb
wb
wb
Mt
Mt
Mt
hN
vY
xC
Sx
hN
Mt
hN
NC
hN
Mt
Mt
Mt
Mt
Mt
Mt
Mt
Mt
Mt
Mt
xC
xC
xC
wb
wb
wb
wb
wb
wb
wb
wb
wb
wb
wb
wb
wb
wb
wb
"}
(11,1,1) = {"
wb
wb
wb
wb
wb
wb
wb
wb
wb
Mt
Mt
Mt
Mt
Mt
Mt
Mt
Mt
Mt
Mt
hN
Ps
hN
Mt
Mt
hN
hN
hN
hN
hN
Mt
Mt
Mt
xC
xC
xC
wb
wb
wb
wb
wb
wb
wb
wb
wb
wb
wb
wb
wb
wb
wb
"}
(12,1,1) = {"
wb
wb
wb
wb
wb
wb
wb
wb
wb
Mt
Mt
Mt
Mt
Mt
hN
hN
hN
hN
hN
hN
NC
hN
hN
hN
hN
sE
sE
sE
hN
hN
hN
hN
hN
hN
hN
wb
wb
wb
wb
wb
wb
wb
wb
wb
wb
wb
wb
wb
wb
wb
"}
(13,1,1) = {"
wb
wb
wb
wb
wb
wb
wb
wb
Mt
Mt
Mt
Mt
Mt
Mt
hN
Bu
PC
US
hN
rL
Ps
Ps
hN
Fz
sE
sE
sE
ZA
sE
he
sE
sE
sE
sE
he
wb
wb
wb
wb
wb
wb
wb
wb
wb
wb
wb
wb
wb
wb
wb
"}
(14,1,1) = {"
wb
wb
wb
wb
wb
wb
wb
Mt
Mt
Mt
Mt
Mt
Mt
Mt
hN
Mx
US
US
hN
Ps
Sb
Ps
hN
Fz
FV
FV
FV
FV
FV
XC
FV
FV
FV
FV
XC
wb
wb
wb
wb
wb
wb
wb
wb
wb
wb
wb
wb
wb
wb
wb
"}
(15,1,1) = {"
wb
wb
wb
wb
wb
wb
Mt
Mt
Mt
Mt
Mt
Mt
Mt
Mt
hN
Vx
US
US
hN
Ps
Sb
Ps
hN
Fz
Ra
Ra
Ra
Ra
Ra
MO
Ra
Ra
Ra
Ra
MO
wb
wb
wb
wb
wb
wb
wb
wb
wb
wb
wb
wb
wb
wb
wb
"}
(16,1,1) = {"
wb
wb
wb
wb
wb
wb
Mt
Mt
Mt
Mt
Mt
Mt
Mt
Mt
hN
hN
EB
hN
hN
Ps
Sb
Ps
hN
Fz
sE
sE
sE
sE
sE
he
sE
sE
sE
sE
he
wb
wb
wb
wb
wb
wb
wb
wb
wb
wb
wb
wb
wb
wb
wb
"}
(17,1,1) = {"
wb
wb
wb
wb
wb
wb
Mt
Mt
hN
hN
hN
hN
hN
hN
hN
qy
rM
LR
hN
Ps
Sb
Ps
Jk
Ps
el
sE
sE
sE
sE
hN
hN
hN
hN
hN
hN
wb
wb
wb
wb
wb
wb
wb
wb
wb
wb
wb
wb
wb
wb
wb
"}
(18,1,1) = {"
wb
wb
wb
wb
wb
Mt
Mt
hN
hN
lq
lq
lq
lq
lq
hN
qy
rM
Ai
hN
Ps
Sb
Ps
hN
Fz
sE
sE
sE
ZA
sE
he
sE
sE
sE
sE
he
wb
wb
wb
wb
wb
wb
wb
wb
wb
wb
wb
wb
wb
wb
wb
"}
(19,1,1) = {"
wb
wb
wb
wb
wb
Mt
Mt
hN
ZX
Ak
Cl
Cl
Cl
Fc
hN
RI
rM
Wh
hN
Ps
Sb
Ps
hN
Fz
FV
FV
FV
FV
FV
XC
FV
FV
FV
FV
XC
wb
wb
wb
wb
wb
wb
wb
wb
wb
wb
wb
wb
wb
wb
wb
"}
(20,1,1) = {"
wb
wb
wb
wb
wb
Mt
Mt
hN
Bb
Ak
eK
Dv
Cl
Ak
hN
RI
rM
rM
Wh
Ps
Sb
Ps
hN
Fz
Ra
Ra
Ra
Ra
Ra
MO
Ra
Ra
Ra
Ra
MO
wb
wb
wb
wb
wb
wb
wb
wb
wb
wb
wb
wb
wb
wb
wb
"}
(21,1,1) = {"
wb
wb
wb
wb
wb
Mt
Mt
hN
ZX
DB
eK
cH
Cl
Ak
Ch
rM
rM
bF
hN
Ps
Sb
Ps
hN
Fz
sE
sE
sE
sE
sE
he
sE
sE
sE
sE
he
wb
wb
wb
wb
wb
wb
wb
wb
wb
wb
wb
wb
wb
wb
wb
"}
(22,1,1) = {"
wb
wb
wb
wb
wb
Mt
Mt
hN
Bb
Ak
eK
Dv
Cl
Ak
hN
pZ
rM
rM
gK
Ps
Sb
Ps
hN
hN
hN
qL
qL
Du
gU
hN
hN
hN
hN
hN
hN
wb
wb
wb
wb
wb
wb
wb
wb
wb
wb
wb
wb
wb
wb
wb
"}
(23,1,1) = {"
wb
wb
wb
wb
wb
Mt
Mt
hN
ZX
Ak
Cl
Cl
Cl
aX
hN
Wh
iH
iH
hN
Ps
Sb
Ps
hN
sT
hN
Dm
Ps
AQ
cQ
hN
Mt
Mt
Mt
xC
xC
wb
wb
wb
wb
wb
wb
wb
wb
wb
wb
wb
wb
wb
wb
wb
"}
(24,1,1) = {"
wb
wb
wb
wb
wb
wb
Mt
hN
hN
lq
lq
lq
lq
lq
hN
hN
hN
hN
hN
Ps
Sb
Ps
SF
Ps
hN
Dm
Ps
Ps
Ps
hN
Mt
Mt
Mt
xC
xC
wb
wb
wb
wb
wb
wb
wb
wb
wb
wb
wb
wb
wb
wb
wb
"}
(25,1,1) = {"
wb
wb
wb
wb
wb
wb
Mt
Mt
hN
hN
hN
hN
hN
hN
hN
YP
YP
YP
hN
Ps
Sb
Ps
hN
QG
hN
Dm
Ps
Ps
Ps
hN
Mt
Mt
Mt
xC
xC
wb
wb
wb
wb
wb
wb
wb
wb
wb
wb
wb
wb
wb
wb
wb
"}
(26,1,1) = {"
wb
wb
wb
wb
wb
wb
wb
Mt
Mt
Mt
Mt
Mt
Mt
hN
Ps
Ps
Ps
Ps
eI
Ps
Sb
Ps
hN
hN
hN
hN
Jk
hN
hN
hN
Mt
Mt
xC
xC
wb
wb
wb
wb
wb
wb
wb
wb
wb
wb
wb
wb
wb
wb
wb
wb
"}
(27,1,1) = {"
wb
wb
wb
wb
wb
wb
wb
Mt
Mt
Mt
Mt
Mt
Mt
hN
BM
hN
ke
fL
hN
Ps
Sb
Ps
hN
zt
kT
kT
kT
DS
dh
hN
hN
hN
xC
xC
wb
wb
wb
wb
wb
wb
wb
wb
wb
wb
wb
wb
wb
wb
wb
wb
"}
(28,1,1) = {"
wb
wb
wb
wb
wb
wb
wb
wb
wb
wb
wb
Mt
Mt
hN
kY
hN
hN
hN
hN
Ps
Sb
Ps
Jk
De
OT
OT
OT
wE
DS
ra
Cl
ra
xC
xC
wb
wb
wb
wb
wb
wb
wb
wb
wb
wb
wb
wb
wb
wb
wb
wb
"}
(29,1,1) = {"
wb
wb
wb
wb
wb
wb
wb
wb
wb
wb
wb
Mt
Mt
hN
hN
hN
NG
Ps
Mf
Ps
Ps
Ps
hN
De
OT
OT
OT
ac
zp
hN
hN
hN
xC
xC
wb
wb
wb
wb
wb
wb
wb
wb
wb
wb
wb
wb
wb
wb
wb
wb
"}
(30,1,1) = {"
wb
wb
wb
wb
wb
wb
wb
wb
wb
wb
wb
xC
Mt
Mt
hN
dC
PZ
lQ
hN
hN
XA
hN
hN
IS
ko
ko
ko
Rw
uK
pQ
vq
xC
xC
xC
wb
wb
wb
wb
wb
wb
wb
wb
wb
wb
wb
wb
wb
wb
wb
wb
"}
(31,1,1) = {"
wb
wb
wb
wb
wb
wb
wb
wb
wb
wb
wb
xC
Mt
Mt
hN
Tw
VD
VD
hN
ah
JN
JN
ah
IR
Cl
Cl
Cl
FU
eK
eK
vq
xC
xC
wb
wb
wb
wb
wb
wb
wb
wb
wb
wb
wb
wb
wb
wb
wb
wb
wb
"}
(32,1,1) = {"
wb
wb
wb
wb
wb
wb
wb
wb
wb
wb
wb
xC
xC
Mt
hN
hN
hN
hN
hN
ah
JN
JN
ah
IR
Cl
Cl
Cl
FU
hQ
uf
vq
xC
xC
wb
wb
wb
wb
wb
wb
wb
wb
wb
wb
wb
wb
wb
wb
wb
wb
wb
"}
(33,1,1) = {"
wb
wb
wb
wb
wb
wb
wb
wb
wb
wb
wb
wb
xC
Mt
Mt
Mt
Mt
Mt
hN
ah
JN
JN
ah
qf
Cl
cH
Cl
FU
Cl
Zn
hN
xC
xC
wb
wb
wb
wb
wb
wb
wb
wb
wb
wb
wb
wb
wb
wb
wb
wb
wb
"}
(34,1,1) = {"
wb
wb
wb
wb
wb
wb
wb
wb
wb
wb
wb
wb
xC
xC
xC
Mt
Mt
Mt
hN
ah
JN
JN
ah
IR
Cl
Cl
Cl
FU
uK
pQ
vq
xC
xC
wb
wb
wb
wb
wb
wb
wb
wb
wb
wb
wb
wb
wb
wb
wb
wb
wb
"}
(35,1,1) = {"
wb
wb
wb
wb
wb
wb
wb
wb
wb
wb
wb
wb
wb
xC
xC
Mt
Mt
Mt
hN
UZ
JN
JN
ah
IR
Cl
Cl
Cl
FU
eK
eK
vq
xC
xC
wb
wb
wb
wb
wb
wb
wb
wb
wb
wb
wb
wb
wb
wb
wb
wb
wb
"}
(36,1,1) = {"
wb
wb
wb
wb
wb
wb
wb
wb
wb
wb
wb
wb
wb
wb
xC
xC
Mt
Mt
hN
hN
AU
hN
hN
ij
Ub
Ub
Ub
Sc
hQ
uf
vq
xC
xC
wb
wb
wb
wb
wb
wb
wb
wb
wb
wb
wb
wb
wb
wb
wb
wb
wb
"}
(37,1,1) = {"
wb
wb
wb
wb
wb
wb
wb
wb
wb
wb
wb
wb
wb
wb
xC
xC
Mt
Mt
hN
Ps
Ps
Ps
hN
Pq
eK
eK
eK
SP
hN
hN
hN
xC
xC
wb
wb
wb
wb
wb
wb
wb
wb
wb
wb
wb
wb
wb
wb
wb
wb
wb
"}
(38,1,1) = {"
wb
wb
wb
wb
wb
wb
wb
wb
wb
wb
wb
wb
wb
wb
wb
xC
xC
Mt
hN
Ps
Wc
Ps
hN
nL
Tf
Tf
Tf
Rn
hN
Mt
Mt
xC
wb
wb
wb
wb
wb
wb
wb
wb
wb
wb
wb
wb
wb
wb
wb
wb
wb
wb
"}
(39,1,1) = {"
wb
wb
wb
wb
wb
wb
wb
wb
wb
wb
wb
wb
wb
wb
wb
wb
xC
Mt
hN
fu
fu
fu
hN
vq
vq
vq
vq
vq
hN
Mt
xC
xC
wb
wb
wb
wb
wb
wb
wb
wb
wb
wb
wb
wb
wb
wb
wb
wb
wb
wb
"}
(40,1,1) = {"
wb
wb
wb
wb
wb
wb
wb
wb
wb
wb
wb
wb
wb
wb
wb
wb
xC
xC
hN
vq
vq
vq
hN
xC
xC
xC
xC
xC
xC
xC
xC
wb
wb
wb
wb
wb
wb
wb
wb
wb
wb
wb
wb
wb
wb
wb
wb
wb
wb
wb
"}
(41,1,1) = {"
wb
wb
wb
wb
wb
wb
wb
wb
wb
wb
wb
wb
wb
wb
wb
wb
wb
xC
xC
xC
xC
xC
xC
xC
xC
xC
xC
wb
wb
wb
wb
wb
wb
wb
wb
wb
wb
wb
wb
wb
wb
wb
wb
wb
wb
wb
wb
wb
wb
wb
"}
(42,1,1) = {"
wb
wb
wb
wb
wb
wb
wb
wb
wb
wb
wb
wb
wb
wb
wb
wb
wb
wb
wb
wb
wb
wb
wb
wb
wb
wb
wb
wb
wb
wb
wb
wb
wb
wb
wb
wb
wb
wb
wb
wb
wb
wb
wb
wb
wb
wb
wb
wb
wb
wb
"}
(43,1,1) = {"
wb
wb
wb
wb
wb
wb
wb
wb
wb
wb
wb
wb
wb
wb
wb
wb
wb
wb
wb
wb
wb
wb
wb
wb
wb
wb
wb
wb
wb
wb
wb
wb
wb
wb
wb
wb
wb
wb
wb
wb
wb
wb
wb
wb
wb
wb
wb
wb
wb
wb
"}
(44,1,1) = {"
wb
wb
wb
wb
wb
wb
wb
wb
wb
wb
wb
wb
wb
wb
wb
wb
wb
wb
wb
wb
wb
wb
wb
wb
wb
wb
wb
wb
wb
wb
wb
wb
wb
wb
wb
wb
wb
wb
wb
wb
wb
wb
wb
wb
wb
wb
wb
wb
wb
wb
"}
(45,1,1) = {"
wb
wb
wb
wb
wb
wb
wb
wb
wb
wb
wb
wb
wb
wb
wb
wb
wb
wb
wb
wb
wb
wb
wb
wb
wb
wb
wb
wb
wb
wb
wb
wb
wb
wb
wb
wb
wb
wb
wb
wb
wb
wb
wb
wb
wb
wb
wb
wb
wb
wb
"}
(46,1,1) = {"
wb
wb
wb
wb
wb
wb
wb
wb
wb
wb
wb
wb
wb
wb
wb
wb
wb
wb
wb
wb
wb
wb
wb
wb
wb
wb
wb
wb
wb
wb
wb
wb
wb
wb
wb
wb
wb
wb
wb
wb
wb
wb
wb
wb
wb
wb
wb
wb
wb
wb
"}
(47,1,1) = {"
wb
wb
wb
wb
wb
wb
wb
wb
wb
wb
wb
wb
wb
wb
wb
wb
wb
wb
wb
wb
wb
wb
wb
wb
wb
wb
wb
wb
wb
wb
wb
wb
wb
wb
wb
wb
wb
wb
wb
wb
wb
wb
wb
wb
wb
wb
wb
wb
wb
wb
"}
(48,1,1) = {"
wb
wb
wb
wb
wb
wb
wb
wb
wb
wb
wb
wb
wb
wb
wb
wb
wb
wb
wb
wb
wb
wb
wb
wb
wb
wb
wb
wb
wb
wb
wb
wb
wb
wb
wb
wb
wb
wb
wb
wb
wb
wb
wb
wb
wb
wb
wb
wb
wb
wb
"}
(49,1,1) = {"
wb
wb
wb
wb
wb
wb
wb
wb
wb
wb
wb
wb
wb
wb
wb
wb
wb
wb
wb
wb
wb
wb
wb
wb
wb
wb
wb
wb
wb
wb
wb
wb
wb
wb
wb
wb
wb
wb
wb
wb
wb
wb
wb
wb
wb
wb
wb
wb
wb
wb
"}
(50,1,1) = {"
wb
wb
wb
wb
wb
wb
wb
wb
wb
wb
wb
wb
wb
wb
wb
wb
wb
wb
wb
wb
wb
wb
wb
wb
wb
wb
wb
wb
wb
wb
wb
wb
wb
wb
wb
wb
wb
wb
wb
wb
wb
wb
wb
wb
wb
wb
wb
wb
wb
wb
"}
