//MAP CONVERTED BY dmm2tgm.py THIS HEADER COMMENT PREVENTS RECONVERSION, DO NOT REMOVE
"a" = (
/turf/open/space/basic,
/area/space)
"d" = (
/turf/open/floor/iron,
/area/space)
"e" = (
/turf/open/floor/iron/smooth,
/area/space)
"h" = (
/obj/structure/rack,
/turf/open/floor/iron/dark/textured_half,
/area/space)
"m" = (
/obj/structure/holosign/barrier/atmos/sturdy,
/turf/open/floor/iron,
/area/space)
"o" = (
/turf/closed/wall/mineral/titanium,
/area/space)
"u" = (
/obj/structure/chair/sofa/bench{
	dir = 4
	},
/turf/open/space/basic,
/area/space)
"v" = (
/obj/structure/shuttle/engine/huge{
	dir = 4
	},
/turf/open/floor/plating/airless,
/area/space)
"y" = (
/turf/closed/wall/mineral/titanium/survival,
/area/space)
"A" = (
/obj/item/kirbyplants{
	icon_state = "plant-17"
	},
/turf/open/space/basic,
/area/space)
"D" = (
/obj/structure/chair/sofa/bench{
	dir = 8
	},
/turf/open/space/basic,
/area/space)
"E" = (
/obj/structure/table,
/obj/item/reagent_containers/food/condiment/saltshaker{
	pixel_x = -4;
	pixel_y = 15
	},
/obj/item/reagent_containers/food/condiment/peppermill{
	pixel_x = 4;
	pixel_y = 15
	},
/turf/open/space/basic,
/area/space)
"G" = (
/obj/structure/window/reinforced/shuttle,
/turf/open/floor/plating,
/area/space)
"I" = (
/obj/structure/table/reinforced,
/turf/open/space/basic,
/area/space)
"J" = (
/obj/structure/table,
/turf/open/space/basic,
/area/space)
"K" = (
/obj/structure/shuttle/engine/heater{
	dir = 4
	},
/obj/structure/window/reinforced/shuttle,
/turf/open/floor/plating,
/area/space)
"U" = (
/obj/structure/chair/sofa/bench/right{
	dir = 4
	},
/turf/open/space/basic,
/area/space)
"W" = (
/obj/structure/chair/sofa/bench/left{
	dir = 8
	},
/turf/open/space/basic,
/area/space)
"X" = (
/obj/structure/closet/crate/bin,
/turf/open/space/basic,
/area/space)
"Y" = (
/turf/open/floor/plating/airless,
/area/space)
"Z" = (
/turf/closed/wall/mineral/titanium/nodiagonal,
/area/space)

(1,1,1) = {"
a
a
a
a
a
a
a
a
a
a
a
a
a
a
a
a
a
a
a
a
a
a
a
a
a
a
a
a
a
a
"}
(2,1,1) = {"
a
a
a
a
a
a
a
a
a
a
a
a
a
a
a
a
a
a
a
a
a
a
a
a
a
a
a
a
a
a
"}
(3,1,1) = {"
a
a
a
a
a
a
a
a
a
a
a
a
a
a
a
a
a
a
a
a
a
a
a
a
a
a
a
a
a
a
"}
(4,1,1) = {"
a
a
a
a
a
a
a
a
a
a
a
a
a
a
a
a
a
a
a
a
a
a
a
a
a
a
a
a
a
a
"}
(5,1,1) = {"
a
a
a
a
a
a
a
a
a
a
a
a
a
a
a
a
a
a
a
a
a
a
a
a
a
a
a
a
a
a
"}
(6,1,1) = {"
a
a
a
a
a
a
a
a
a
a
a
a
a
a
a
a
a
a
a
a
a
a
a
a
a
a
a
a
a
a
"}
(7,1,1) = {"
a
a
a
a
a
a
a
a
a
a
a
a
a
a
a
a
a
a
a
a
a
a
a
a
a
a
a
a
a
a
"}
(8,1,1) = {"
a
a
a
a
a
a
a
a
a
a
a
a
a
a
a
a
a
a
a
a
a
a
a
a
a
a
a
a
a
a
"}
(9,1,1) = {"
a
a
a
a
a
a
a
a
a
a
a
a
a
a
a
a
a
a
a
a
a
a
a
a
a
a
a
a
a
a
"}
(10,1,1) = {"
a
a
a
a
a
a
a
a
a
a
a
a
a
a
a
a
a
a
a
a
a
a
a
a
a
a
a
a
a
a
"}
(11,1,1) = {"
a
a
a
a
a
a
a
a
a
a
a
a
a
a
a
a
a
a
a
a
a
a
a
a
a
a
a
a
a
a
"}
(12,1,1) = {"
a
a
a
a
a
a
a
a
a
Z
Z
Z
Z
Z
a
a
a
a
a
a
a
a
a
a
a
a
a
a
a
a
"}
(13,1,1) = {"
a
a
a
a
a
a
a
a
a
Z
I
a
A
Z
a
a
a
a
a
a
a
a
a
a
a
a
a
a
a
a
"}
(14,1,1) = {"
a
a
a
a
a
a
a
a
a
G
u
U
a
Z
a
a
a
Z
a
a
a
G
a
a
a
a
a
a
a
a
"}
(15,1,1) = {"
a
a
a
a
a
a
a
a
a
G
E
J
a
Z
a
a
a
Z
a
a
a
G
a
a
a
a
a
a
a
a
"}
(16,1,1) = {"
a
a
a
a
a
a
a
a
a
G
D
W
a
a
a
a
a
a
a
a
a
G
a
a
a
a
a
a
a
a
"}
(17,1,1) = {"
a
a
a
a
a
a
a
a
a
o
X
a
a
Z
a
a
a
Z
a
a
a
o
a
a
a
a
a
a
a
a
"}
(18,1,1) = {"
a
a
a
a
a
a
a
a
o
Z
Z
Z
Z
Z
Z
a
Z
Z
Z
Z
Z
Z
o
a
a
a
a
a
a
a
"}
(19,1,1) = {"
a
a
a
a
a
a
a
a
y
y
y
y
y
Z
d
d
d
Z
y
y
y
y
y
a
a
a
a
a
a
a
"}
(20,1,1) = {"
a
a
a
a
a
a
a
a
y
e
e
e
y
m
d
d
d
m
y
e
e
e
y
a
a
a
a
a
a
a
"}
(21,1,1) = {"
a
a
a
a
a
a
a
a
e
e
e
e
e
m
d
Z
d
m
e
e
e
e
e
a
a
a
a
a
a
a
"}
(22,1,1) = {"
a
a
a
a
a
a
a
a
e
e
e
e
e
m
d
h
d
m
e
e
e
e
e
a
a
a
a
a
a
a
"}
(23,1,1) = {"
a
a
a
a
a
a
a
a
e
e
e
e
e
m
d
h
d
m
e
e
e
e
e
a
a
a
a
a
a
a
"}
(24,1,1) = {"
a
a
a
a
a
a
a
a
y
e
e
e
y
m
d
h
d
m
y
e
e
e
y
a
a
a
a
a
a
a
"}
(25,1,1) = {"
a
a
a
a
a
a
a
a
y
y
y
y
y
m
d
h
d
m
y
y
y
y
y
a
a
a
a
a
a
a
"}
(26,1,1) = {"
a
a
a
a
a
a
a
a
y
e
e
e
y
m
d
h
d
m
y
e
e
e
y
a
a
a
a
a
a
a
"}
(27,1,1) = {"
a
a
a
a
a
a
a
a
e
e
e
e
e
m
d
h
d
m
e
e
e
e
e
a
a
a
a
a
a
a
"}
(28,1,1) = {"
a
a
a
a
a
a
a
a
e
e
e
e
e
m
d
h
d
m
e
e
e
e
e
a
a
a
a
a
a
a
"}
(29,1,1) = {"
a
a
a
a
a
a
a
a
e
e
e
e
e
m
d
Z
d
m
e
e
e
e
e
a
a
a
a
a
a
a
"}
(30,1,1) = {"
a
a
a
a
a
a
a
a
y
e
e
e
y
m
d
d
d
m
y
e
e
e
y
a
a
a
a
a
a
a
"}
(31,1,1) = {"
a
a
a
a
a
a
a
a
y
y
y
y
y
Z
d
d
d
Z
y
y
y
y
y
a
a
a
a
a
a
a
"}
(32,1,1) = {"
a
a
a
a
a
a
a
a
o
K
K
K
Z
Z
Z
a
Z
Z
Z
K
K
K
o
a
a
a
a
a
a
a
"}
(33,1,1) = {"
a
a
a
a
a
a
a
a
a
Y
Y
v
G
a
a
a
a
a
G
Y
Y
v
a
a
a
a
a
a
a
a
"}
(34,1,1) = {"
a
a
a
a
a
a
a
a
a
a
a
a
G
a
a
a
a
a
G
a
a
a
a
a
a
a
a
a
a
a
"}
(35,1,1) = {"
a
a
a
a
a
a
a
a
a
a
a
a
G
a
a
a
a
a
G
a
a
a
a
a
a
a
a
a
a
a
"}
(36,1,1) = {"
a
a
a
a
a
a
a
a
a
a
a
a
K
K
K
Z
K
K
K
a
a
a
a
a
a
a
a
a
a
a
"}
(37,1,1) = {"
a
a
a
a
a
a
a
a
a
a
a
a
Y
Y
v
Z
Y
Y
v
a
a
a
a
a
a
a
a
a
a
a
"}
(38,1,1) = {"
a
a
a
a
a
a
a
a
a
a
a
a
a
a
a
a
a
a
a
a
a
a
a
a
a
a
a
a
a
a
"}
(39,1,1) = {"
a
a
a
a
a
a
a
a
a
a
a
a
a
a
a
a
a
a
a
a
a
a
a
a
a
a
a
a
a
a
"}
(40,1,1) = {"
a
a
a
a
a
a
a
a
a
a
a
a
a
a
a
a
a
a
a
a
a
a
a
a
a
a
a
a
a
a
"}
