//MAP CONVERTED BY dmm2tgm.py THIS HEADER COMMENT PREVENTS RECONVERSION, DO NOT REMOVE
"aa" = (
/turf/open/space/basic,
/area/template_noop)
"ac" = (
/obj/machinery/door/airlock/command/glass{
	name = "Cockpit";
	req_access_txt = "19"
	},
/turf/open/floor/mineral/titanium/blue,
/area/shuttle/escape)
"ad" = (
/turf/closed/wall/mineral/titanium,
/area/shuttle/escape)
"an" = (
/turf/open/floor/mineral/titanium/blue,
/area/shuttle/escape)
"ao" = (
/obj/structure/chair{
	dir = 4
	},
/obj/item/radio/intercom{
	pixel_x = -29
	},
/turf/open/floor/mineral/titanium,
/area/shuttle/escape)
"az" = (
/obj/machinery/status_display/evac,
/turf/closed/wall/mineral/titanium,
/area/shuttle/escape)
"aC" = (
/turf/open/floor/mineral/titanium,
/area/shuttle/escape)
"aF" = (
/obj/structure/table,
/obj/item/storage/firstaid/fire{
	pixel_x = 3;
	pixel_y = 3
	},
/obj/item/storage/firstaid/regular,
/obj/item/extinguisher,
/obj/item/crowbar,
/turf/open/floor/mineral/titanium,
/area/shuttle/escape)
"aG" = (
/turf/open/floor/mineral/plastitanium/red/brig,
/area/shuttle/escape)
"aM" = (
/obj/structure/chair{
	dir = 8
	},
/turf/open/floor/mineral/titanium,
/area/shuttle/escape)
"aP" = (
/obj/machinery/door/airlock/titanium{
	name = "Emergency Shuttle Airlock"
	},
/obj/docking_port/mobile/emergency{
	name = "Box emergency shuttle"
	},
/turf/open/floor/plating,
/area/shuttle/escape)
"aT" = (
/obj/effect/spawner/structure/window/hollow/reinforced/end,
/turf/open/floor/plating,
/area/shuttle/escape)
"aV" = (
/obj/machinery/door/airlock/titanium{
	name = "Emergency Shuttle Airlock"
	},
/turf/open/floor/plating,
/area/shuttle/escape)
"bb" = (
/obj/machinery/sleeper{
	dir = 8
	},
/turf/open/floor/mineral/titanium,
/area/shuttle/escape)
"bg" = (
/obj/item/storage/firstaid/regular,
/turf/open/floor/mineral/titanium,
/area/shuttle/escape)
"bj" = (
/obj/structure/chair{
	dir = 1
	},
/turf/open/floor/mineral/titanium,
/area/shuttle/escape)
"bk" = (
/obj/structure/shuttle/engine/propulsion,
/turf/open/floor/plating/airless,
/area/shuttle/escape)
"eS" = (
/obj/effect/spawner/structure/window/hollow/reinforced/end{
	dir = 8
	},
/turf/open/floor/plating,
/area/shuttle/escape)
"ga" = (
/obj/structure/chair{
	dir = 8
	},
/turf/open/floor/mineral/plastitanium/red/brig,
/area/shuttle/escape)
"iL" = (
/obj/machinery/vending/wallmed{
	name = "Emergency NanoMed";
	use_power = 0
	},
/turf/closed/wall/mineral/titanium,
/area/shuttle/escape)
"kE" = (
/obj/effect/spawner/structure/window/hollow/reinforced/end{
	dir = 1
	},
/turf/open/floor/plating,
/area/shuttle/escape)
"mD" = (
/obj/effect/spawner/structure/window/hollow/reinforced/middle{
	dir = 4
	},
/turf/open/floor/plating,
/area/shuttle/escape)
"po" = (
/obj/effect/spawner/structure/window/hollow/reinforced/end{
	dir = 4
	},
/turf/open/floor/plating,
/area/shuttle/escape)
"tM" = (
/obj/structure/shuttle/engine/heater,
/obj/structure/window/reinforced{
	dir = 1
	},
/turf/open/floor/plating/airless,
/area/shuttle/escape)
"yj" = (
/obj/structure/chair{
	dir = 4
	},
/turf/open/floor/mineral/plastitanium/red/brig,
/area/shuttle/escape)
"EW" = (
/obj/structure/chair{
	dir = 4
	},
/turf/open/floor/mineral/titanium,
/area/shuttle/escape)
"FV" = (
/obj/structure/chair{
	dir = 8
	},
/obj/item/radio/intercom{
	pixel_x = 29
	},
/turf/open/floor/mineral/titanium,
/area/shuttle/escape)
"NX" = (
/obj/structure/chair,
/turf/open/floor/mineral/titanium,
/area/shuttle/escape)
"UK" = (
/obj/machinery/vending/wallmed{
	name = "Emergency NanoMed";
	pixel_x = 32;
	use_power = 0
	},
/turf/open/floor/mineral/titanium,
/area/shuttle/escape)
"VP" = (
/obj/effect/spawner/structure/window/hollow/reinforced,
/turf/open/floor/plating,
/area/shuttle/escape)
"VW" = (
/turf/open/space/basic,
/area/shuttle/escape)
"XC" = (
/obj/machinery/door/airlock/security/glass{
	name = "Brig";
	req_access_txt = "2"
	},
/turf/open/floor/mineral/titanium/blue,
/area/shuttle/escape)
"XN" = (
/turf/closed/wall/mineral/titanium,
/area/template_noop)

(1,1,1) = {"
aa
aa
aa
aa
VW
ad
ad
ad
ad
aP
ad
kE
mD
aT
ad
aV
ad
ad
ad
ad
ad
XN
"}
(2,1,1) = {"
aa
VW
VW
VW
VW
ad
aF
EW
EW
aC
ao
EW
EW
EW
EW
aC
eS
bb
aC
bb
tM
bk
"}
(3,1,1) = {"
aa
VW
VW
VW
VW
az
aC
an
an
an
an
an
an
an
an
an
po
aC
aC
aC
tM
bk
"}
(4,1,1) = {"
aa
VW
VW
VW
VW
ad
aC
an
aM
aM
aM
aM
aM
aM
aM
an
aC
aC
UK
bg
tM
bk
"}
(5,1,1) = {"
aa
VW
VW
VW
VW
ac
an
an
bj
kE
aT
iL
kE
aT
NX
an
az
ad
ad
ad
ad
ad
"}
(6,1,1) = {"
aa
VW
VW
VW
VW
ad
aC
an
EW
EW
EW
EW
EW
EW
EW
an
aC
VP
yj
yj
tM
bk
"}
(7,1,1) = {"
aa
VW
VW
VW
VW
az
aC
an
an
an
an
an
an
an
an
an
an
XC
aG
aG
tM
bk
"}
(8,1,1) = {"
aa
VW
VW
VW
VW
ad
aF
aM
aM
aM
FV
aM
aM
aM
aM
aF
aC
VP
ga
ga
tM
bk
"}
(9,1,1) = {"
aa
VW
VW
VW
VW
ad
ad
ad
VP
ad
ad
ad
VP
ad
ad
ad
ad
ad
ad
ad
ad
ad
"}
(10,1,1) = {"
aa
aa
aa
aa
aa
aa
aa
aa
aa
aa
aa
aa
aa
aa
aa
aa
aa
aa
aa
aa
aa
aa
"}
(11,1,1) = {"
aa
aa
aa
aa
aa
aa
aa
aa
aa
aa
aa
aa
aa
aa
aa
aa
aa
aa
aa
aa
aa
aa
"}
